1111111111111
10010000P00C1
10P0011111001
100011E000011
1111111111111