1111111111111
1C01000000C01
10C00111110C1
1P0011E000001
1111111111111