111111111111
1E10C1001C01
100C110C11C1
1C000CC00001
1011000CC011
1CC10CC000P1
111111111111