1111111111111
1C01000000C01
10C0011111EC1
1P00110000001
1111111111111