111111111111
1E10C1M01C01
10MC110C11C1
1C000CC00001
101100MCC011
1CC10CCM00P1
111111111111